Name	Subdivision Level 1	Capital
Aach (Hegau)	DE-BW	
Aachen	DE-NW	
Aalen	DE-BW	
Abenberg	DE-BY	
Abensberg	DE-BY	
Achern	DE-BW	
Achim (Landkreis Verden)	DE-NI	
Adelsheim	DE-BW	
Adenau	DE-RP	
Adorf/Vogtl.	DE-SN	
Ahaus	DE-NW	
Ahlen	DE-NW	
Ahrensburg	DE-SH	
Aichach	DE-BY	
Aichtal	DE-BW	
Aken (Elbe)	DE-ST	
Albstadt	DE-BW	
Alfeld (Leine)	DE-NI	
Allendorf (Lumda)	DE-HE	
Allstedt	DE-ST	
Alpirsbach	DE-BW	
Alsdorf	DE-NW	
Alsfeld	DE-HE	
Alsleben (Saale)	DE-ST	
Altdorf bei Nürnberg	DE-BY	
Altena	DE-NW	
Altenberg (Erzgebirge)	DE-SN	
Altenburg	DE-TH	
Altenkirchen (Westerwald)	DE-RP	
Altensteig	DE-BW	
Altentreptow	DE-MV	
Altlandsberg	DE-BB	
Altötting	DE-BY	
Alzenau	DE-BY	
Alzey	DE-RP	
Amberg	DE-BY	
Amöneburg	DE-HE	
Amorbach	DE-BY	
Andernach	DE-RP	
Angermünde	DE-BB	
Anklam	DE-MV	
Annaberg-Buchholz	DE-SN	
Annaburg	DE-ST	
Annweiler am Trifels	DE-RP	
Ansbach	DE-BY	
Apolda	DE-TH	
Arendsee (Altmark)	DE-ST	
Arneburg	DE-ST	
Arnis	DE-SH	
Arnsberg	DE-NW	
Arnstadt	DE-TH	
Arnstein (Unterfranken)	DE-BY	
Arnstein (Sachsen-Anhalt)	DE-ST	
Artern/Unstrut	DE-TH	
Arzberg (Oberfranken)	DE-BY	
Aschaffenburg	DE-BY	
Aschersleben	DE-ST	
Asperg	DE-BW	
Aßlar	DE-HE	
Attendorn	DE-NW	
Aub	DE-BY	
Aue (Sachsen)	DE-SN	
Auerbach in der Oberpfalz	DE-BY	
Auerbach/Vogtl.	DE-SN	
Augsburg	DE-BY	
Augustusburg	DE-SN	
Aulendorf	DE-BW	
Auma-Weidatal	DE-TH	
Aurich	DE-NI	
Babenhausen (Hessen)	DE-HE	
Bacharach	DE-RP	
Backnang	DE-BW	
Bad Aibling	DE-BY	
Bad Arolsen	DE-HE	
Bad Belzig	DE-BB	
Bad Bentheim	DE-NI	
Bad Bergzabern	DE-RP	
Bad Berka	DE-TH	
Bad Berleburg	DE-NW	
Bad Berneck im Fichtelgebirge	DE-BY	
Bad Bevensen	DE-NI	
Bad Bibra	DE-ST	
Bad Blankenburg	DE-TH	
Bad Bramstedt	DE-SH	
Bad Breisig	DE-RP	
Bad Brückenau	DE-BY	
Bad Buchau	DE-BW	
Bad Camberg	DE-HE	
Bad Colberg-Heldburg	DE-TH	
Bad Doberan	DE-MV	
Bad Driburg	DE-NW	
Bad Düben	DE-SN	
Bad Dürkheim	DE-RP	
Bad Dürrenberg	DE-ST	
Bad Dürrheim	DE-BW	
Bad Elster	DE-SN	
Bad Ems	DE-RP	
Baden-Baden	DE-BW	
Bad Fallingbostel	DE-NI	
Bad Frankenhausen/Kyffhäuser	DE-TH	
Bad Freienwalde (Oder)	DE-BB	
Bad Friedrichshall	DE-BW	
Bad Gandersheim	DE-NI	
Bad Gottleuba-Berggießhübel	DE-SN	
Bad Griesbach im Rottal	DE-BY	
Bad Harzburg	DE-NI	
Bad Herrenalb	DE-BW	
Bad Hersfeld	DE-HE	
Bad Homburg vor der Höhe	DE-HE	
Bad Honnef	DE-NW	
Bad Hönningen	DE-RP	
Bad Iburg	DE-NI	
Bad Karlshafen	DE-HE	
Bad Kissingen	DE-BY	
Bad König	DE-HE	
Bad Königshofen im Grabfeld	DE-BY	
Bad Köstritz	DE-TH	
Bad Kötzting	DE-BY	
Bad Kreuznach	DE-RP	
Bad Krozingen	DE-BW	
Bad Laasphe	DE-NW	
Bad Langensalza	DE-TH	
Bad Lauchstädt	DE-ST	
Bad Lausick	DE-SN	
Bad Lauterberg im Harz	DE-NI	
Bad Liebenstein (Gemeinde)	DE-TH	
Bad Liebenwerda	DE-BB	
Bad Liebenzell	DE-BW	
Bad Lippspringe	DE-NW	
Bad Lobenstein	DE-TH	
Bad Marienberg (Westerwald)	DE-RP	
Bad Mergentheim	DE-BW	
Bad Münder am Deister	DE-NI	
Bad Münstereifel	DE-NW	
Bad Muskau	DE-SN	
Bad Nauheim	DE-HE	
Bad Nenndorf	DE-NI	
Bad Neuenahr-Ahrweiler	DE-RP	
Bad Neustadt an der Saale	DE-BY	
Bad Oeynhausen	DE-NW	
Bad Oldesloe	DE-SH	
Bad Orb	DE-HE	
Bad Pyrmont	DE-NI	
Bad Rappenau	DE-BW	
Bad Reichenhall	DE-BY	
Bad Rodach	DE-BY	
Bad Sachsa	DE-NI	
Bad Säckingen	DE-BW	
Bad Salzdetfurth	DE-NI	
Bad Salzuflen	DE-NW	
Bad Salzungen	DE-TH	
Bad Saulgau	DE-BW	
Bad Schandau	DE-SN	
Bad Schmiedeberg	DE-ST	
Bad Schussenried	DE-BW	
Bad Schwalbach	DE-HE	
Bad Schwartau	DE-SH	
Bad Segeberg	DE-SH	
Bad Sobernheim	DE-RP	
Bad Soden am Taunus	DE-HE	
Bad Soden-Salmünster	DE-HE	
Bad Sooden-Allendorf	DE-HE	
Bad Staffelstein	DE-BY	
Bad Sulza	DE-TH	
Bad Sülze	DE-MV	
Bad Teinach-Zavelstein	DE-BW	
Bad Tennstedt	DE-TH	
Bad Tölz	DE-BY	
Bad Urach	DE-BW	
Bad Vilbel	DE-HE	
Bad Waldsee	DE-BW	
Bad Wildbad	DE-BW	
Bad Wildungen	DE-HE	
Bad Wilsnack	DE-BB	
Bad Wimpfen	DE-BW	
Bad Windsheim	DE-BY	
Bad Wörishofen	DE-BY	
Bad Wünnenberg	DE-NW	
Bad Wurzach	DE-BW	
Baesweiler	DE-NW	
Baiersdorf	DE-BY	
Balingen	DE-BW	
Ballenstedt	DE-ST	
Balve	DE-NW	
Bamberg	DE-BY	
Barby	DE-ST	
Bargteheide	DE-SH	
Barmstedt	DE-SH	
Bärnau	DE-BY	
Barntrup	DE-NW	
Barsinghausen	DE-NI	
Barth	DE-MV	
Baruth/Mark	DE-BB	
Bassum	DE-NI	
Battenberg (Eder)	DE-HE	
Baumholder	DE-RP	
Baunach	DE-BY	
Baunatal	DE-HE	
Bautzen	DE-SN	
Bayreuth	DE-BY	
Bebra	DE-HE	
Beckum	DE-NW	
Bedburg	DE-NW	
Beelitz	DE-BB	
Beerfelden	DE-HE	
Beeskow	DE-BB	
Beilngries	DE-BY	
Beilstein (Württemberg)	DE-BW	
Belgern-Schildau	DE-SN	
Bendorf	DE-RP	
Bensheim	DE-HE	
Berching	DE-BY	
Berga/Elster	DE-TH	
Bergen (Landkreis Celle)	DE-NI	
Bergen auf Rügen	DE-MV	
Bergheim	DE-NW	
Bergisch Gladbach	DE-NW	
Bergkamen	DE-NW	
Bergneustadt	DE-NW	
Berka/Werra	DE-TH	
Berlin	DE-BE	Federal
Bernau bei Berlin	DE-BB	
Bernburg (Saale)	DE-ST	
Bernkastel-Kues	DE-RP	
Bernsdorf (Oberlausitz)	DE-SN	
Bernstadt a. d. Eigen	DE-SN	
Bersenbrück	DE-NI	
Besigheim	DE-BW	
Betzdorf	DE-RP	
Betzenstein	DE-BY	
Beverungen	DE-NW	
Bexbach	DE-SL	
Biberach an der Riß	DE-BW	
Biedenkopf	DE-HE	
Bielefeld	DE-NW	
Biesenthal	DE-BB	
Bietigheim-Bissingen	DE-BW	
Billerbeck	DE-NW	
Bingen am Rhein	DE-RP	
Birkenfeld (Nahe)	DE-RP	
Bischofsheim an der Rhön	DE-BY	
Bischofswerda	DE-SN	
Bismark (Altmark)	DE-ST	
Bitburg	DE-RP	
Bitterfeld-Wolfen	DE-ST	
Blankenburg (Harz)	DE-ST	
Blankenhain	DE-TH	
Blaubeuren	DE-BW	
Blaustein	DE-BW	
Bleckede	DE-NI	
Bleicherode	DE-TH	
Blieskastel	DE-SL	
Blomberg	DE-NW	
Blumberg	DE-BW	
Bobingen	DE-BY	
Böblingen	DE-BW	
Bocholt	DE-NW	
Bochum	DE-NW	
Bockenem	DE-NI	
Bodenwerder	DE-NI	
Bogen (Stadt)	DE-BY	
Böhlen (Sachsen)	DE-SN	
Boizenburg/Elbe	DE-MV	
Bonn	DE-NW	
Bonndorf im Schwarzwald	DE-BW	
Bönnigheim	DE-BW	
Bopfingen	DE-BW	
Boppard	DE-RP	
Borgentreich	DE-NW	
Borgholzhausen	DE-NW	
Borken	DE-NW	
Borken (Hessen)	DE-HE	
Borkum	DE-NI	
Borna	DE-SN	
Bornheim (Rheinland)	DE-NW	
Bottrop	DE-NW	
Boxberg (Baden)	DE-BW	
Brackenheim	DE-BW	
Brake (Unterweser)	DE-NI	
Brakel	DE-NW	
Bramsche	DE-NI	
Brandenburg an der Havel	DE-BB	
Brand-Erbisdorf	DE-SN	
Stadt Brandis	DE-SN	
Braubach	DE-RP	
Braunfels	DE-HE	
Braunlage	DE-NI	
Bräunlingen	DE-BW	
Braunsbedra	DE-ST	
Braunschweig	DE-NI	
Breckerfeld	DE-NW	
Bredstedt	DE-SH	
Breisach am Rhein	DE-BW	
Bremen	DE-HB	
Bremerhaven	DE-HB	
Bremervörde	DE-NI	
Bretten	DE-BW	
Breuberg	DE-HE	
Brilon	DE-NW	
Brotterode-Trusetal	DE-TH	
Bruchköbel	DE-HE	
Bruchsal	DE-BW	
Brück	DE-BB	
Brüel	DE-MV	
Brühl (Rheinland)	DE-NW	
Brunsbüttel	DE-SH	
Brüssow	DE-BB	
Buchen (Odenwald)	DE-BW	
Buchholz in der Nordheide	DE-NI	
Buchloe	DE-BY	
Bückeburg	DE-NI	
Buckow (Märkische Schweiz)	DE-BB	
Büdelsdorf	DE-SH	
Büdingen	DE-HE	
Bühl (Baden)	DE-BW	
Bünde	DE-NW	
Büren (Westfalen)	DE-NW	
Burg (bei Magdeburg)	DE-ST	
Burgau	DE-BY	
Burgbernheim	DE-BY	
Burgdorf (Region Hannover)	DE-NI	
Bürgel (Thüringen)	DE-TH	
Burghausen	DE-BY	
Burgkunstadt	DE-BY	
Burglengenfeld	DE-BY	
Burgstädt	DE-SN	
Burg Stargard	DE-MV	
Burgwedel	DE-NI	
Burladingen	DE-BW	
Burscheid	DE-NW	
Bürstadt	DE-HE	
Buttelstedt	DE-TH	
Buttstädt	DE-TH	
Butzbach	DE-HE	
Bützow	DE-MV	
Buxtehude	DE-NI	
Calau	DE-BB	
Calbe (Saale)	DE-ST	
Calw	DE-BW	
Castrop-Rauxel	DE-NW	
Celle	DE-NI	
Cham (Oberpfalz)	DE-BY	
Chemnitz	DE-SN	
Clausthal-Zellerfeld	DE-NI	
Clingen	DE-TH	
Cloppenburg	DE-NI	
Coburg	DE-BY	
Cochem	DE-RP	
Coesfeld	DE-NW	
Colditz	DE-SN	
Coswig (Sachsen)	DE-SN	
Coswig (Anhalt)	DE-ST	
Cottbus	DE-BB	
Crailsheim	DE-BW	
Creglingen	DE-BW	
Creußen	DE-BY	
Creuzburg	DE-TH	
Crimmitschau	DE-SN	
Crivitz	DE-MV	
Cuxhaven	DE-NI	
Dachau	DE-BY	
Dahlen (Sachsen)	DE-SN	
Dahme/Mark	DE-BB	
Dahn	DE-RP	
Damme (Dümmer)	DE-NI	
Dannenberg (Elbe)	DE-NI	
Dargun	DE-MV	
Darmstadt	DE-HE	
Dassel	DE-NI	
Dassow	DE-MV	
Datteln	DE-NW	
Daun	DE-RP	
Deggendorf	DE-BY	
Deidesheim	DE-RP	
Delbrück	DE-NW	
Delitzsch	DE-SN	
Delmenhorst	DE-NI	
Demmin	DE-MV	
Dessau-Roßlau	DE-ST	
Detmold	DE-NW	
Dettelbach	DE-BY	
Dieburg	DE-HE	
Diemelstadt	DE-HE	
Diepholz	DE-NI	
Dierdorf	DE-RP	
Dietenheim	DE-BW	
Dietfurt an der Altmühl	DE-BY	
Dietzenbach	DE-HE	
Diez	DE-RP	
Dillenburg	DE-HE	
Dillingen an der Donau	DE-BY	
Dillingen/Saar	DE-SL	
Dingelstädt	DE-TH	
Dingolfing	DE-BY	
Dinkelsbühl	DE-BY	
Dinklage	DE-NI	
Dinslaken	DE-NW	
Dippoldiswalde	DE-SN	
Dissen am Teutoburger Wald	DE-NI	
Ditzingen	DE-BW	
Döbeln	DE-SN	
Doberlug-Kirchhain	DE-BB	
Döbern	DE-BB	
Dohna	DE-SN	
Dömitz	DE-MV	
Dommitzsch	DE-SN	
Donaueschingen	DE-BW	
Donauwörth	DE-BY	
Donzdorf	DE-BW	
Dorfen	DE-BY	
Dormagen	DE-NW	
Dornburg-Camburg	DE-TH	
Dornhan	DE-BW	
Dornstetten	DE-BW	
Dorsten	DE-NW	
Dortmund	DE-NW	
Dransfeld	DE-NI	
Drebkau	DE-BB	
Dreieich	DE-HE	
Drensteinfurt	DE-NW	
Dresden	DE-SN	State
Drolshagen	DE-NW	
Duderstadt	DE-NI	
Duisburg	DE-NW	
Dülmen	DE-NW	
Düren	DE-NW	
Düsseldorf	DE-NW	State
Ebeleben	DE-TH	
Eberbach	DE-BW	
Ebermannstadt	DE-BY	
Ebern	DE-BY	
Ebersbach an der Fils	DE-BW	
Ebersbach-Neugersdorf	DE-SN	
Ebersberg	DE-BY	
Eberswalde	DE-BB	
Eckartsberga	DE-ST	
Eckernförde	DE-SH	
Edenkoben	DE-RP	
Egeln	DE-ST	
Eggenfelden	DE-BY	
Eggesin	DE-MV	
Ehingen (Donau)	DE-BW	
Ehrenfriedersdorf	DE-SN	
Eibelstadt	DE-BY	
Eibenstock	DE-SN	
Eichstätt	DE-BY	
Eilenburg	DE-SN	
Einbeck	DE-NI	
Eisenach	DE-TH	
Eisenberg (Thüringen)	DE-TH	
Eisenberg (Pfalz)	DE-RP	
Eisenhüttenstadt	DE-BB	
Eisfeld	DE-TH	
Lutherstadt Eisleben	DE-ST	
Eislingen/Fils	DE-BW	
Ellingen	DE-BY	
Ellrich	DE-TH	
Ellwangen (Jagst)	DE-BW	
Elmshorn	DE-SH	
Elsdorf (Rheinland)	DE-NW	
Elsfleth	DE-NI	
Elsterberg	DE-SN	
Elsterwerda	DE-BB	
Elstra	DE-SN	
Elterlein	DE-SN	
Eltmann	DE-BY	
Eltville am Rhein	DE-HE	
Elzach	DE-BW	
Elze	DE-NI	
Emden	DE-NI	
Emmelshausen	DE-RP	
Emmendingen	DE-BW	
Emmerich am Rhein	DE-NW	
Emsdetten	DE-NW	
Endingen am Kaiserstuhl	DE-BW	
Engen	DE-BW	
Enger	DE-NW	
Ennepetal	DE-NW	
Ennigerloh	DE-NW	
Eppelheim	DE-BW	
Eppingen	DE-BW	
Eppstein	DE-HE	
Erbach (Donau)	DE-BW	
Erbach (Odenwald)	DE-HE	
Erbendorf	DE-BY	
Erding	DE-BY	
Erftstadt	DE-NW	
Erfurt	DE-TH	State
Erkelenz	DE-NW	
Erkner	DE-BB	
Erkrath	DE-NW	
Erlangen	DE-BY	
Erlenbach am Main	DE-BY	
Erlensee	DE-HE	
Erwitte	DE-NW	
Eschborn	DE-HE	
Eschenbach in der Oberpfalz	DE-BY	
Eschershausen	DE-NI	
Eschwege	DE-HE	
Eschweiler	DE-NW	
Esens	DE-NI	
Espelkamp	DE-NW	
Essen	DE-NW	
Esslingen am Neckar	DE-BW	
Ettenheim	DE-BW	
Ettlingen	DE-BW	
Euskirchen	DE-NW	
Eutin	DE-SH	
Falkenberg/Elster	DE-BB	
Falkensee	DE-BB	
Falkenstein/Harz	DE-ST	
Falkenstein/Vogtl.	DE-SN	
Fehmarn	DE-SH	
Fellbach	DE-BW	
Felsberg (Hessen)	DE-HE	
Feuchtwangen	DE-BY	
Filderstadt	DE-BW	
Finsterwalde	DE-BB	
Fladungen	DE-BY	
Flensburg	DE-SH	
Flöha	DE-SN	
Flörsheim am Main	DE-HE	
Florstadt	DE-HE	
Forchheim	DE-BY	
Forchtenberg	DE-BW	
Forst (Lausitz)	DE-BB	
Frankenau	DE-HE	
Frankenberg (Eder)	DE-HE	
Frankenberg/Sa.	DE-SN	
Frankenthal (Pfalz)	DE-RP	
Frankfurt am Main	DE-HE	
Frankfurt (Oder)	DE-BB	
Franzburg	DE-MV	
Frauenstein (Erzgebirge)	DE-SN	
Frechen	DE-NW	
Freiberg am Neckar	DE-BW	
Freiberg	DE-SN	
Freiburg im Breisgau	DE-BW	
Freilassing	DE-BY	
Freinsheim	DE-RP	
Freising	DE-BY	
Freital	DE-SN	
Freren	DE-NI	
Freudenberg (Baden)	DE-BW	
Freudenberg (Siegerland)	DE-NW	
Freudenstadt	DE-BW	
Freyburg (Unstrut)	DE-ST	
Freystadt	DE-BY	
Freyung	DE-BY	
Fridingen an der Donau	DE-BW	
Friedberg (Bayern)	DE-BY	
Friedberg (Hessen)	DE-HE	
Friedland (Mecklenburg)	DE-MV	
Friedland (Niederlausitz)	DE-BB	
Friedrichroda	DE-TH	
Friedrichsdorf	DE-HE	
Friedrichshafen	DE-BW	
Friedrichstadt	DE-SH	
Friedrichsthal (Saar)	DE-SL	
Friesack	DE-BB	
Friesoythe	DE-NI	
Fritzlar	DE-HE	
Frohburg	DE-SN	
Fröndenberg/Ruhr	DE-NW	
Fulda	DE-HE	
Fürstenau	DE-NI	
Fürstenberg/Havel	DE-BB	
Fürstenfeldbruck	DE-BY	
Fürstenwalde/Spree	DE-BB	
Fürth	DE-BY	
Furth im Wald	DE-BY	
Furtwangen im Schwarzwald	DE-BW	
Füssen	DE-BY	
Gadebusch	DE-MV	
Gaggenau	DE-BW	
Gaildorf	DE-BW	
Gammertingen	DE-BW	
Garbsen	DE-NI	
Garching bei München	DE-BY	
Gardelegen	DE-ST	
Garding	DE-SH	
Gartz (Oder)	DE-BB	
Garz/Rügen	DE-MV	
Gau-Algesheim	DE-RP	
Gebesee	DE-TH	
Gedern	DE-HE	
Geesthacht	DE-SH	
Geestland	DE-NI	
Gefell	DE-TH	
Gefrees	DE-BY	
Gehrden	DE-NI	
Gehren	DE-TH	
Geilenkirchen	DE-NW	
Geisa	DE-TH	
Geiselhöring	DE-BY	
Geisenfeld	DE-BY	
Geisenheim	DE-HE	
Geisingen	DE-BW	
Geislingen (Zollernalbkreis)	DE-BW	
Geislingen an der Steige	DE-BW	
Geithain	DE-SN	
Geldern	DE-NW	
Gelnhausen	DE-HE	
Gelsenkirchen	DE-NW	
Gemünden am Main	DE-BY	
Gemünden (Wohra)	DE-HE	
Gengenbach	DE-BW	
Genthin	DE-ST	
Georgsmarienhütte	DE-NI	
Gera	DE-TH	
Gerabronn	DE-BW	
Gerbstedt	DE-ST	
Geretsried	DE-BY	
Geringswalde	DE-SN	
Gerlingen	DE-BW	
Germering	DE-BY	
Germersheim	DE-RP	
Gernsbach	DE-BW	
Gernsheim	DE-HE	
Gerolstein	DE-RP	
Gerolzhofen	DE-BY	
Gersfeld (Rhön)	DE-HE	
Gersthofen	DE-BY	
Gescher	DE-NW	
Geseke	DE-NW	
Gevelsberg	DE-NW	
Geyer	DE-SN	
Giengen an der Brenz	DE-BW	
Gießen	DE-HE	
Gifhorn	DE-NI	
Ginsheim-Gustavsburg	DE-HE	
Gladbeck	DE-NW	
Gladenbach	DE-HE	
Glashütte (Sachsen)	DE-SN	
Glauchau	DE-SN	
Glinde	DE-SH	
Glücksburg (Ostsee)	DE-SH	
Glückstadt	DE-SH	
Gnoien	DE-MV	
Goch	DE-NW	
Goldberg (Mecklenburg)	DE-MV	
Goldkronach	DE-BY	
Golßen	DE-BB	
Gommern	DE-ST	
Göppingen	DE-BW	
Görlitz	DE-SN	
Goslar	DE-NI	
Gößnitz (Thüringen)	DE-TH	
Gotha	DE-TH	
Göttingen	DE-NI	
Grabow (Elde)	DE-MV	
Grafenau (Niederbayern)	DE-BY	
Gräfenberg	DE-BY	
Gräfenhainichen	DE-ST	
Gräfenthal	DE-TH	
Grafenwöhr	DE-BY	
Grafing bei München	DE-BY	
Gransee	DE-BB	
Grebenau	DE-HE	
Grebenstein	DE-HE	
Greding	DE-BY	
Greifswald	DE-MV	
Greiz	DE-TH	
Greußen	DE-TH	
Greven	DE-NW	
Grevenbroich	DE-NW	
Grevesmühlen	DE-MV	
Griesheim	DE-HE	
Grimma	DE-SN	
Grimmen	DE-MV	
Gröditz	DE-SN	
Groitzsch	DE-SN	
Gronau (Leine)	DE-NI	
Gronau (Westf.)	DE-NW	
Gröningen	DE-ST	
Großalmerode	DE-HE	
Groß-Bieberau	DE-HE	
Großbottwar	DE-BW	
Großbreitenbach	DE-TH	
Großenehrich	DE-TH	
Großenhain	DE-SN	
Groß-Gerau	DE-HE	
Großräschen	DE-BB	
Großröhrsdorf	DE-SN	
Großschirma	DE-SN	
Groß-Umstadt	DE-HE	
Grünberg (Hessen)	DE-HE	
Grünhain-Beierfeld	DE-SN	
Grünsfeld	DE-BW	
Grünstadt	DE-RP	
Guben	DE-BB	
Gudensberg	DE-HE	
Güglingen	DE-BW	
Gummersbach	DE-NW	
Gundelfingen an der Donau	DE-BY	
Gundelsheim (Württemberg)	DE-BW	
Günzburg	DE-BY	
Gunzenhausen	DE-BY	
Güsten	DE-ST	
Güstrow	DE-MV	
Gütersloh	DE-NW	
Gützkow	DE-MV	
Haan	DE-NW	
Hachenburg	DE-RP	
Hadamar	DE-HE	
Hagen	DE-NW	
Hagenbach	DE-RP	
Hagenow	DE-MV	
Haiger	DE-HE	
Haigerloch	DE-BW	
Hainichen	DE-SN	
Haiterbach	DE-BW	
Halberstadt	DE-ST	
Haldensleben	DE-ST	
Halle (Saale)	DE-ST	
Halle (Westf.)	DE-NW	
Hallenberg	DE-NW	
Hallstadt	DE-BY	
Haltern am See	DE-NW	
Halver	DE-NW	
Hamburg	DE-HH	
Hameln	DE-NI	
Hamm	DE-NW	
Hammelburg	DE-BY	
Hamminkeln	DE-NW	
Hanau	DE-HE	
Hannover	DE-NI	State
Hann. Münden	DE-NI	
Harburg (Schwaben)	DE-BY	
Hardegsen	DE-NI	
Haren (Ems)	DE-NI	
Harsewinkel	DE-NW	
Hartenstein (Sachsen)	DE-SN	
Hartha	DE-SN	
Harzgerode	DE-ST	
Haselünne	DE-NI	
Haslach im Kinzigtal	DE-BW	
Haßfurt	DE-BY	
Hattersheim am Main	DE-HE	
Hattingen	DE-NW	
Hatzfeld (Eder)	DE-HE	
Hausach	DE-BW	
Hauzenberg	DE-BY	
Havelberg	DE-ST	
Havelsee	DE-BB	
Hayingen	DE-BW	
Hechingen	DE-BW	
Hecklingen	DE-ST	
Heide (Holstein)	DE-SH	
Heideck	DE-BY	
Heidelberg	DE-BW	
Heidenau (Sachsen)	DE-SN	
Heidenheim an der Brenz	DE-BW	
Heilbad Heiligenstadt	DE-TH	
Heilbronn	DE-BW	
Heiligenhafen	DE-SH	
Heiligenhaus	DE-NW	
Heilsbronn	DE-BY	
Heimbach (Eifel)	DE-NW	
Heimsheim	DE-BW	
Heinsberg	DE-NW	
Heitersheim	DE-BW	
Heldrungen	DE-TH	
Helmbrechts	DE-BY	
Helmstedt	DE-NI	
Hemau	DE-BY	
Hemer	DE-NW	
Hemmingen (Niedersachsen)	DE-NI	
Hemmoor	DE-NI	
Hemsbach	DE-BW	
Hennef (Sieg)	DE-NW	
Hennigsdorf	DE-BB	
Heppenheim (Bergstraße)	DE-HE	
Herbolzheim	DE-BW	
Herborn	DE-HE	
Herbrechtingen	DE-BW	
Herbstein	DE-HE	
Herdecke	DE-NW	
Herdorf	DE-RP	
Herford	DE-NW	
Heringen/Helme	DE-TH	
Heringen (Werra)	DE-HE	
Hermeskeil	DE-RP	
Hermsdorf (Thüringen)	DE-TH	
Herne	DE-NW	
Herrenberg	DE-BW	
Herrieden	DE-BY	
Herrnhut	DE-SN	
Hersbruck	DE-BY	
Herten	DE-NW	
Herzberg am Harz	DE-NI	
Herzberg (Elster)	DE-BB	
Herzogenaurach	DE-BY	
Herzogenrath	DE-NW	
Hessisch Lichtenau	DE-HE	
Hessisch Oldendorf	DE-NI	
Hettingen	DE-BW	
Hettstedt	DE-ST	
Heubach	DE-BW	
Heusenstamm	DE-HE	
Hilchenbach	DE-NW	
Hildburghausen	DE-TH	
Hilden	DE-NW	
Hildesheim	DE-NI	
Hillesheim (Eifel)	DE-RP	
Hilpoltstein	DE-BY	
Hirschau	DE-BY	
Hirschberg (Saale)	DE-TH	
Hirschhorn (Neckar)	DE-HE	
Hitzacker (Elbe)	DE-NI	
Hochheim am Main	DE-HE	
Höchstadt an der Aisch	DE-BY	
Höchstädt an der Donau	DE-BY	
Hockenheim	DE-BW	
Hof (Saale)	DE-BY	
Hofgeismar	DE-HE	
Hofheim am Taunus	DE-HE	
Hofheim in Unterfranken	DE-BY	
Hohenberg an der Eger	DE-BY	
Hohenleuben	DE-TH	
Hohenmölsen	DE-ST	
Hohen Neuendorf	DE-BB	
Hohenstein-Ernstthal	DE-SN	
Hohnstein (Sächsische Schweiz)	DE-SN	
Höhr-Grenzhausen	DE-RP	
Hollfeld	DE-BY	
Holzgerlingen	DE-BW	
Holzminden	DE-NI	
Homberg (Efze)	DE-HE	
Homberg (Ohm)	DE-HE	
Homburg	DE-SL	
Horb am Neckar	DE-BW	
Hornbach	DE-RP	
Horn-Bad Meinberg	DE-NW	
Hornberg	DE-BW	
Hörstel	DE-NW	
Horstmar	DE-NW	
Höxter	DE-NW	
Hoya	DE-NI	
Hoyerswerda	DE-SN	
Hückelhoven	DE-NW	
Hückeswagen	DE-NW	
Hüfingen	DE-BW	
Hünfeld	DE-HE	
Hungen	DE-HE	
Hürth	DE-NW	
Husum	DE-SH	
Ibbenbüren	DE-NW	
Ichenhausen	DE-BY	
Idar-Oberstein	DE-RP	
Idstein	DE-HE	
Illertissen	DE-BY	
Ilmenau	DE-TH	
Ilsenburg (Harz)	DE-ST	
Ilshofen	DE-BW	
Immenhausen	DE-HE	
Immenstadt im Allgäu	DE-BY	
Ingelfingen	DE-BW	
Ingelheim am Rhein	DE-RP	
Ingolstadt	DE-BY	
Iphofen	DE-BY	
Iserlohn	DE-NW	
Isny im Allgäu	DE-BW	
Isselburg	DE-NW	
Itzehoe	DE-SH	
Jarmen	DE-MV	
Jena	DE-TH	
Jerichow	DE-ST	
Jessen (Elster)	DE-ST	
Jever	DE-NI	
Joachimsthal	DE-BB	
Johanngeorgenstadt	DE-SN	
Jöhstadt	DE-SN	
Jülich	DE-NW	
Jüterbog	DE-BB	
Kaarst	DE-NW	
Kahla	DE-TH	
Kaisersesch	DE-RP	
Kaiserslautern	DE-RP	
Kalbe (Milde)	DE-ST	
Kalkar	DE-NW	
Kaltenkirchen	DE-SH	
Kaltennordheim	DE-TH	
Kamen	DE-NW	
Kamenz	DE-SN	
Kamp-Lintfort	DE-NW	
Kandel (Pfalz)	DE-RP	
Kandern	DE-BW	
Kappeln	DE-SH	
Karben	DE-HE	
Karlsruhe	DE-BW	
Karlstadt	DE-BY	
Kassel	DE-HE	
Kastellaun	DE-RP	
Katzenelnbogen	DE-RP	
Kaub	DE-RP	
Kaufbeuren	DE-BY	
Kehl	DE-BW	
Kelbra (Kyffhäuser)	DE-ST	
Kelheim	DE-BY	
Kelkheim (Taunus)	DE-HE	
Kellinghusen	DE-SH	
Kelsterbach	DE-HE	
Kemberg	DE-ST	
Kemnath	DE-BY	
Kempen	DE-NW	
Kempten (Allgäu)	DE-BY	
Kenzingen	DE-BW	
Kerpen	DE-NW	
Ketzin/Havel	DE-BB	
Kevelaer	DE-NW	
Kiel	DE-SH	State
Kierspe	DE-NW	
Kindelbrück	DE-TH	
Kirchberg (Sachsen)	DE-SN	
Kirchberg an der Jagst	DE-BW	
Kirchberg (Hunsrück)	DE-RP	
Kirchen (Sieg)	DE-RP	
Kirchenlamitz	DE-BY	
Kirchhain	DE-HE	
Kirchheimbolanden	DE-RP	
Kirchheim unter Teck	DE-BW	
Kirn	DE-RP	
Kirtorf	DE-HE	
Kitzingen	DE-BY	
Kitzscher	DE-SN	
Kleve	DE-NW	
Klingenberg am Main	DE-BY	
Klingenthal	DE-SN	
Klötze	DE-ST	
Klütz	DE-MV	
Knittlingen	DE-BW	
Koblenz	DE-RP	
Kohren-Sahlis	DE-SN	
Kolbermoor	DE-BY	
Kölleda	DE-TH	
Köln	DE-NW	
Königsberg in Bayern	DE-BY	
Königsbrück	DE-SN	
Königsbrunn	DE-BY	
Königsee-Rottenbach	DE-TH	
Königslutter am Elm	DE-NI	
Königstein im Taunus	DE-HE	
Königstein (Sächsische Schweiz)	DE-SN	
Königswinter	DE-NW	
Königs Wusterhausen	DE-BB	
Könnern	DE-ST	
Konstanz	DE-BW	
Konz	DE-RP	
Korbach	DE-HE	
Korntal-Münchingen	DE-BW	
Kornwestheim	DE-BW	
Korschenbroich	DE-NW	
Köthen (Anhalt)	DE-ST	
Kraichtal	DE-BW	
Krakow am See	DE-MV	
Kranichfeld	DE-TH	
Krautheim (Jagst)	DE-BW	
Krefeld	DE-NW	
Kremmen	DE-BB	
Krempe (Steinburg)	DE-SH	
Kreuztal	DE-NW	
Kronach	DE-BY	
Kronberg im Taunus	DE-HE	
Kröpelin	DE-MV	
Kroppenstedt	DE-ST	
Krumbach (Schwaben)	DE-BY	
Kühlungsborn	DE-MV	
Kulmbach	DE-BY	
Külsheim	DE-BW	
Künzelsau	DE-BW	
Kupferberg	DE-BY	
Kuppenheim	DE-BW	
Kusel	DE-RP	
Kyllburg	DE-RP	
Kyritz	DE-BB	
Laage	DE-MV	
Laatzen	DE-NI	
Ladenburg	DE-BW	
Lage (Lippe)	DE-NW	
Lahnstein	DE-RP	
Lahr/Schwarzwald	DE-BW	
Laichingen	DE-BW	
Lambrecht (Pfalz)	DE-RP	
Lampertheim	DE-HE	
Landau an der Isar	DE-BY	
Landau in der Pfalz	DE-RP	
Landsberg am Lech	DE-BY	
Landsberg (Saalekreis)	DE-ST	
Landshut	DE-BY	
Landstuhl	DE-RP	
Langelsheim	DE-NI	
Langen (Hessen)	DE-HE	
Langenau	DE-BW	
Langenburg	DE-BW	
Langenfeld (Rheinland)	DE-NW	
Langenhagen	DE-NI	
Langenselbold	DE-HE	
Langenzenn	DE-BY	
Langewiesen	DE-TH	
Lassan	DE-MV	
Laubach	DE-HE	
Laucha an der Unstrut	DE-ST	
Lauchhammer	DE-BB	
Lauchheim	DE-BW	
Lauda-Königshofen	DE-BW	
Lauenburg/Elbe	DE-SH	
Lauf an der Pegnitz	DE-BY	
Laufen (Salzach)	DE-BY	
Laufenburg (Baden)	DE-BW	
Lauffen am Neckar	DE-BW	
Lauingen (Donau)	DE-BY	
Laupheim	DE-BW	
Lauscha	DE-TH	
Lauta	DE-SN	
Lauter-Bernsbach	DE-SN	
Lauterbach (Hessen)	DE-HE	
Lauterecken	DE-RP	
Lauterstein	DE-BW	
Lebach	DE-SL	
Lebus	DE-BB	
Leer (Ostfriesland)	DE-NI	
Lehesten (Thüringer Wald)	DE-TH	
Lehrte	DE-NI	
Leichlingen (Rheinland)	DE-NW	
Leimen (Baden)	DE-BW	
Leinefelde-Worbis	DE-TH	
Leinfelden-Echterdingen	DE-BW	
Leipheim	DE-BY	
Leipzig	DE-SN	
Leisnig	DE-SN	
Lemgo	DE-NW	
Lengenfeld (Vogtland)	DE-SN	
Lengerich (Westfalen)	DE-NW	
Lennestadt	DE-NW	
Lenzen (Elbe)	DE-BB	
Leonberg	DE-BW	
Leun	DE-HE	
Leuna	DE-ST	
Leutenberg	DE-TH	
Leutershausen	DE-BY	
Leutkirch im Allgäu	DE-BW	
Leverkusen	DE-NW	
Lich	DE-HE	
Lichtenau (Baden)	DE-BW	
Lichtenau (Westfalen)	DE-NW	
Lichtenberg (Oberfranken)	DE-BY	
Lichtenfels (Oberfranken)	DE-BY	
Lichtenfels (Hessen)	DE-HE	
Lichtenstein/Sa.	DE-SN	
Liebenau (Hessen)	DE-HE	
Liebenwalde	DE-BB	
Lieberose	DE-BB	
Liebstadt	DE-SN	
Limbach-Oberfrohna	DE-SN	
Limburg an der Lahn	DE-HE	
Lindau (Bodensee)	DE-BY	
Linden (Hessen)	DE-HE	
Lindenberg im Allgäu	DE-BY	
Lindenfels	DE-HE	
Lindow (Mark)	DE-BB	
Lingen (Ems)	DE-NI	
Linnich	DE-NW	
Linz am Rhein	DE-RP	
Lippstadt	DE-NW	
Löbau	DE-SN	
Löffingen	DE-BW	
Lohmar	DE-NW	
Lohne (Oldenburg)	DE-NI	
Löhne	DE-NW	
Lohr am Main	DE-BY	
Loitz	DE-MV	
Lollar	DE-HE	
Lommatzsch	DE-SN	
Löningen	DE-NI	
Lorch (Württemberg)	DE-BW	
Lorch (Rheingau)	DE-HE	
Lörrach	DE-BW	
Lorsch	DE-HE	
Lößnitz (Erzgebirge)	DE-SN	
Löwenstein	DE-BW	
Lübbecke	DE-NW	
Lübben (Spreewald)	DE-BB	
Lübbenau/Spreewald	DE-BB	
Lübeck	DE-SH	
Lübtheen	DE-MV	
Lübz	DE-MV	
Lüchow (Wendland)	DE-NI	
Lucka	DE-TH	
Luckau	DE-BB	
Luckenwalde	DE-BB	
Lüdenscheid	DE-NW	
Lüdinghausen	DE-NW	
Ludwigsburg	DE-BW	
Ludwigsfelde	DE-BB	
Ludwigshafen am Rhein	DE-RP	
Ludwigslust	DE-MV	
Ludwigsstadt	DE-BY	
Lugau/Erzgeb.	DE-SN	
Lügde	DE-NW	
Lüneburg	DE-NI	
Lünen	DE-NW	
Lunzenau	DE-SN	
Lütjenburg	DE-SH	
Lützen	DE-ST	
Lychen	DE-BB	
Magdala	DE-TH	
Magdeburg	DE-ST	State
Mahlberg	DE-BW	
Mainbernheim	DE-BY	
Mainburg	DE-BY	
Maintal	DE-HE	
Mainz	DE-RP	State
Malchin	DE-MV	
Malchow (Mecklenburg)	DE-MV	
Mannheim	DE-BW	
Manderscheid	DE-RP	
Mansfeld	DE-ST	
Marbach am Neckar	DE-BW	
Marburg	DE-HE	
Marienberg	DE-SN	
Marienmünster	DE-NW	
Markdorf	DE-BW	
Markgröningen	DE-BW	
Märkisch Buchholz	DE-BB	
Markkleeberg	DE-SN	
Markneukirchen	DE-SN	
Markranstädt	DE-SN	
Marktbreit	DE-BY	
Marktheidenfeld	DE-BY	
Marktleuthen	DE-BY	
Marktoberdorf	DE-BY	
Marktredwitz	DE-BY	
Marktsteft	DE-BY	
Marl	DE-NW	
Marlow	DE-MV	
Marne (Holstein)	DE-SH	
Marsberg	DE-NW	
Maulbronn	DE-BW	
Maxhütte-Haidhof	DE-BY	
Mayen	DE-RP	
Mechernich	DE-NW	
Meckenheim (Rheinland)	DE-NW	
Medebach	DE-NW	
Meerane	DE-SN	
Meerbusch	DE-NW	
Meersburg	DE-BW	
Meinerzhagen	DE-NW	
Meiningen	DE-TH	
Meisenheim	DE-RP	
Meißen	DE-SN	
Meldorf	DE-SH	
Melle	DE-NI	
Mellrichstadt	DE-BY	
Melsungen	DE-HE	
Memmingen	DE-BY	
Menden (Sauerland)	DE-NW	
Mendig	DE-RP	
Mengen	DE-BW	
Meppen	DE-NI	
Merkendorf (Mittelfranken)	DE-BY	
Merseburg	DE-ST	
Merzig	DE-SL	
Meschede	DE-NW	
Meßkirch	DE-BW	
Meßstetten	DE-BW	
Mettmann	DE-NW	
Metzingen	DE-BW	
Meuselwitz	DE-TH	
Meyenburg	DE-BB	
Michelstadt	DE-HE	
Miesbach	DE-BY	
Miltenberg	DE-BY	
Mindelheim	DE-BY	
Minden	DE-NW	
Mirow	DE-MV	
Mittenwalde	DE-BB	
Mitterteich	DE-BY	
Mittweida	DE-SN	
Möckern	DE-ST	
Möckmühl	DE-BW	
Moers	DE-NW	
Mölln	DE-SH	
Mönchengladbach	DE-NW	
Monheim am Rhein	DE-NW	
Monheim (Schwaben)	DE-BY	
Monschau	DE-NW	
Montabaur	DE-RP	
Moosburg an der Isar	DE-BY	
Mörfelden-Walldorf	DE-HE	
Moringen	DE-NI	
Mosbach	DE-BW	
Mössingen	DE-BW	
Mücheln (Geiseltal)	DE-ST	
Mügeln	DE-SN	
Mühlacker	DE-BW	
Mühlberg/Elbe	DE-BB	
Mühldorf am Inn	DE-BY	
Mühlhausen/Thüringen	DE-TH	
Mühlheim am Main	DE-HE	
Mühlheim an der Donau	DE-BW	
Mülheim an der Ruhr	DE-NW	
Mülheim-Kärlich	DE-RP	
Müllheim (Baden)	DE-BW	
Müllrose	DE-BB	
Münchberg	DE-BY	
Müncheberg	DE-BB	
München	DE-BY	State
Münchenbernsdorf	DE-TH	
Munderkingen	DE-BW	
Münnerstadt	DE-BY	
Münsingen (Württemberg)	DE-BW	
Munster (Örtze)	DE-NI	
Münster (Westfalen)	DE-NW	
Münstermaifeld	DE-RP	
Münzenberg	DE-HE	
Murrhardt	DE-BW	
Nabburg	DE-BY	
Nagold (Stadt)	DE-BW	
Naila	DE-BY	
Nassau (Lahn)	DE-RP	
Nastätten	DE-RP	
Nauen	DE-BB	
Naumburg (Hessen)	DE-HE	
Naumburg (Saale)	DE-ST	
Naunhof	DE-SN	
Nebra (Unstrut)	DE-ST	
Neckarbischofsheim	DE-BW	
Neckargemünd	DE-BW	
Neckarsteinach	DE-HE	
Neckarsulm	DE-BW	
Neresheim	DE-BW	
Netphen	DE-NW	
Nettetal	DE-NW	
Netzschkau	DE-SN	
Neu-Anspach	DE-HE	
Neubrandenburg	DE-MV	
Neubukow	DE-MV	
Neubulach	DE-BW	
Neuburg an der Donau	DE-BY	
Neudenau	DE-BW	
Neuenbürg	DE-BW	
Neuenburg am Rhein	DE-BW	
Neuenhaus	DE-NI	
Neuenrade	DE-NW	
Neuenstadt am Kocher	DE-BW	
Neuenstein (Hohenlohe)	DE-BW	
Neuerburg	DE-RP	
Neuffen	DE-BW	
Neuhaus am Rennweg	DE-TH	
Neu-Isenburg	DE-HE	
Neukalen	DE-MV	
Neukirchen (Knüll)	DE-HE	
Neukirchen-Vluyn	DE-NW	
Neukloster	DE-MV	
Neumark (bei Weimar)	DE-TH	
Neumarkt in der Oberpfalz	DE-BY	
Neumarkt-Sankt Veit	DE-BY	
Neumünster	DE-SH	
Neunburg vorm Wald	DE-BY	
Neunkirchen (Saar)	DE-SL	
Neuötting	DE-BY	
Neuruppin	DE-BB	
Neusalza-Spremberg	DE-SN	
Neusäß	DE-BY	
Neuss	DE-NW	
Neustadt an der Aisch	DE-BY	
Neustadt an der Donau	DE-BY	
Neustadt an der Waldnaab	DE-BY	
Neustadt am Kulm	DE-BY	
Neustadt am Rübenberge	DE-NI	
Neustadt an der Orla	DE-TH	
Neustadt an der Weinstraße	DE-RP	
Neustadt bei Coburg	DE-BY	
Neustadt (Dosse)	DE-BB	
Neustadt-Glewe	DE-MV	
Neustadt (Hessen)	DE-HE	
Neustadt in Holstein	DE-SH	
Neustadt in Sachsen	DE-SN	
Neustrelitz	DE-MV	
Neutraubling	DE-BY	
Neu-Ulm	DE-BY	
Neuwied	DE-RP	
Nidda	DE-HE	
Niddatal	DE-HE	
Nidderau	DE-HE	
Nideggen	DE-NW	
Niebüll	DE-SH	
Niedenstein	DE-HE	
Niederkassel	DE-NW	
Niedernhall	DE-BW	
Nieder-Olm	DE-RP	
Niederstetten	DE-BW	
Niederstotzingen	DE-BW	
Nieheim	DE-NW	
Niemegk	DE-BB	
Nienburg (Saale)	DE-ST	
Nienburg/Weser	DE-NI	
Nierstein	DE-RP	
Niesky	DE-SN	
Nittenau	DE-BY	
Norden (Ostfriesland)	DE-NI	
Nordenham	DE-NI	
Norderney	DE-NI	
Norderstedt	DE-SH	
Nordhausen	DE-TH	
Nordhorn	DE-NI	
Nördlingen	DE-BY	
Northeim	DE-NI	
Nortorf	DE-SH	
Nossen	DE-SN	
Nürnberg	DE-BY	
Nürtingen	DE-BW	
Oberasbach	DE-BY	
Oberharz am Brocken	DE-ST	
Oberhausen	DE-NW	
Oberhof	DE-TH	
Oberkirch (Baden)	DE-BW	
Oberkochen	DE-BW	
Oberlungwitz	DE-SN	
Obermoschel	DE-RP	
Obernburg am Main	DE-BY	
Oberndorf am Neckar	DE-BW	
Obernkirchen	DE-NI	
Ober-Ramstadt	DE-HE	
Oberriexingen	DE-BW	
Obertshausen	DE-HE	
Oberursel (Taunus)	DE-HE	
Oberviechtach	DE-BY	
Oberweißbach/Thüringer Wald	DE-TH	
Oberwesel	DE-RP	
Oberwiesenthal	DE-SN	
Ochsenfurt	DE-BY	
Ochsenhausen	DE-BW	
Ochtrup	DE-NW	
Oderberg	DE-BB	
Oebisfelde-Weferlingen	DE-ST	
Oederan	DE-SN	
Oelde	DE-NW	
Oelsnitz/Erzgeb.	DE-SN	
Oelsnitz/Vogtl.	DE-SN	
Oer-Erkenschwick	DE-NW	
Oerlinghausen	DE-NW	
Oestrich-Winkel	DE-HE	
Oettingen in Bayern	DE-BY	
Offenbach am Main	DE-HE	
Offenburg	DE-BW	
Ohrdruf	DE-TH	
Öhringen	DE-BW	
Olbernhau	DE-SN	
Olching	DE-BY	
Oldenburg (Oldenburg)	DE-NI	
Oldenburg in Holstein	DE-SH	
Olfen	DE-NW	
Olpe	DE-NW	
Olsberg	DE-NW	
Oppenau	DE-BW	
Oppenheim	DE-RP	
Oranienbaum-Wörlitz	DE-ST	
Oranienburg	DE-BB	
Orlamünde	DE-TH	
Ornbau	DE-BY	
Ortenberg (Hessen)	DE-HE	
Ortrand	DE-BB	
Oschatz	DE-SN	
Oschersleben (Bode)	DE-ST	
Osnabrück	DE-NI	
Osterburg (Altmark)	DE-ST	
Osterburken	DE-BW	
Osterfeld (Sachsen-Anhalt)	DE-ST	
Osterhofen	DE-BY	
Osterholz-Scharmbeck	DE-NI	
Osterode am Harz	DE-NI	
Osterwieck	DE-ST	
Ostfildern	DE-BW	
Ostheim vor der Rhön	DE-BY	
Osthofen	DE-RP	
Östringen	DE-BW	
Ostritz	DE-SN	
Otterberg	DE-RP	
Otterndorf	DE-NI	
Ottweiler	DE-SL	
Overath	DE-NW	
Owen	DE-BW	
Paderborn	DE-NW	
Papenburg	DE-NI	
Pappenheim	DE-BY	
Parchim	DE-MV	
Parsberg	DE-BY	
Pasewalk	DE-MV	
Passau	DE-BY	
Pattensen	DE-NI	
Pausa-Mühltroff	DE-SN	
Pegau	DE-SN	
Pegnitz (Stadt)	DE-BY	
Peine	DE-NI	
Peitz	DE-BB	
Penig	DE-SN	
Penkun	DE-MV	
Penzberg	DE-BY	
Penzlin	DE-MV	
Perleberg	DE-BB	
Petershagen	DE-NW	
Pfaffenhofen an der Ilm	DE-BY	
Pfarrkirchen	DE-BY	
Pforzheim	DE-BW	
Pfreimd	DE-BY	
Pfullendorf	DE-BW	
Pfullingen	DE-BW	
Pfungstadt	DE-HE	
Philippsburg	DE-BW	
Pinneberg	DE-SH	
Pirmasens	DE-RP	
Pirna	DE-SN	
Plattling	DE-BY	
Plau am See	DE-MV	
Plaue	DE-TH	
Plauen	DE-SN	
Plettenberg	DE-NW	
Pleystein	DE-BY	
Plochingen	DE-BW	
Plön	DE-SH	
Pockau-Lengefeld	DE-SN	
Pocking	DE-BY	
Pohlheim	DE-HE	
Polch	DE-RP	
Porta Westfalica (Stadt)	DE-NW	
Pößneck	DE-TH	
Potsdam	DE-BB	State
Pottenstein (Oberfranken)	DE-BY	
Preetz	DE-SH	
Premnitz	DE-BB	
Prenzlau	DE-BB	
Pressath	DE-BY	
Preußisch Oldendorf	DE-NW	
Prichsenstadt	DE-BY	
Pritzwalk	DE-BB	
Prüm	DE-RP	
Puchheim	DE-BY	
Pulheim	DE-NW	
Pulsnitz	DE-SN	
Putbus	DE-MV	
Putlitz	DE-BB	
Püttlingen	DE-SL	
Quakenbrück	DE-NI	
Quedlinburg	DE-ST	
Querfurt	DE-ST	
Quickborn	DE-SH	
Rabenau (Sachsen)	DE-SN	
Radeberg	DE-SN	
Radebeul	DE-SN	
Radeburg	DE-SN	
Radevormwald	DE-NW	
Radolfzell am Bodensee	DE-BW	
Raguhn-Jeßnitz	DE-ST	
Rahden	DE-NW	
Rain (Lech)	DE-BY	
Ramstein-Miesenbach	DE-RP	
Ranis	DE-TH	
Ransbach-Baumbach	DE-RP	
Rastatt	DE-BW	
Rastenberg	DE-TH	
Rathenow	DE-BB	
Ratingen	DE-NW	
Ratzeburg	DE-SH	
Rauenberg	DE-BW	
Raunheim	DE-HE	
Rauschenberg	DE-HE	
Ravensburg	DE-BW	
Ravenstein	DE-BW	
Recklinghausen	DE-NW	
Rees	DE-NW	
Regen (Stadt)	DE-BY	
Regensburg	DE-BY	
Regis-Breitingen	DE-SN	
Rehau	DE-BY	
Rehburg-Loccum	DE-NI	
Rehna	DE-MV	
Reichelsheim (Wetterau)	DE-HE	
Reichenbach im Vogtland	DE-SN	
Reichenbach/O.L.	DE-SN	
Reinbek	DE-SH	
Reinfeld (Holstein)	DE-SH	
Reinheim	DE-HE	
Remagen	DE-RP	
Remda-Teichel	DE-TH	
Remscheid	DE-NW	
Remseck am Neckar	DE-BW	
Renchen	DE-BW	
Rendsburg	DE-SH	
Rennerod	DE-RP	
Renningen	DE-BW	
Rerik	DE-MV	
Rethem (Aller)	DE-NI	
Reutlingen	DE-BW	
Rheda-Wiedenbrück	DE-NW	
Rhede	DE-NW	
Rheinau (Baden)	DE-BW	
Rheinbach	DE-NW	
Rheinberg	DE-NW	
Rheinböllen	DE-RP	
Rheine	DE-NW	
Rheinfelden (Baden)	DE-BW	
Rheinsberg	DE-BB	
Rheinstetten	DE-BW	
Rhens	DE-RP	
Rhinow	DE-BB	
Ribnitz-Damgarten	DE-MV	
Richtenberg	DE-MV	
Riedenburg	DE-BY	
Riedlingen	DE-BW	
Riedstadt	DE-HE	
Rieneck	DE-BY	
Riesa	DE-SN	
Rietberg	DE-NW	
Rinteln	DE-NI	
Röbel/Müritz	DE-MV	
Rochlitz	DE-SN	
Rockenhausen	DE-RP	
Rodalben	DE-RP	
Rodenberg	DE-NI	
Rödental	DE-BY	
Rödermark	DE-HE	
Rodewisch	DE-SN	
Rodgau	DE-HE	
Roding	DE-BY	
Römhild	DE-TH	
Romrod	DE-HE	
Ronneburg (Thüringen)	DE-TH	
Ronnenberg	DE-NI	
Rosbach vor der Höhe	DE-HE	
Rosenfeld	DE-BW	
Rosenheim	DE-BY	
Rosenthal (Hessen)	DE-HE	
Rösrath	DE-NW	
Roßleben	DE-TH	
Roßwein	DE-SN	
Rostock	DE-MV	
Rotenburg an der Fulda	DE-HE	
Rotenburg (Wümme)	DE-NI	
Roth	DE-BY	
Rötha	DE-SN	
Röthenbach an der Pegnitz	DE-BY	
Rothenburg/Oberlausitz	DE-SN	
Rothenburg ob der Tauber	DE-BY	
Rothenfels	DE-BY	
Rottenburg am Neckar	DE-BW	
Rottenburg an der Laaber	DE-BY	
Röttingen	DE-BY	
Rottweil	DE-BW	
Rötz	DE-BY	
Rüdesheim am Rhein	DE-HE	
Rudolstadt	DE-TH	
Ruhla	DE-TH	
Ruhland	DE-BB	
Runkel	DE-HE	
Rüsselsheim am Main	DE-HE	
Rutesheim	DE-BW	
Rüthen	DE-NW	
Saalburg-Ebersdorf	DE-TH	
Saalfeld/Saale	DE-TH	
Saarbrücken	DE-SL	State
Saarburg	DE-RP	
Saarlouis	DE-SL	
Sachsenhagen	DE-NI	
Sachsenheim	DE-BW	
Salzgitter	DE-NI	
Salzkotten	DE-NW	
Salzwedel	DE-ST	
Sandau (Elbe)	DE-ST	
Sandersdorf-Brehna	DE-ST	
Sangerhausen	DE-ST	
Sankt Augustin	DE-NW	
Sankt Goar	DE-RP	
Sankt Goarshausen	DE-RP	
Sarstedt	DE-NI	
Sassenberg	DE-NW	
Sassnitz	DE-MV	
Sayda	DE-SN	
Schalkau	DE-TH	
Schauenstein	DE-BY	
Scheer	DE-BW	
Scheibenberg	DE-SN	
Scheinfeld	DE-BY	
Schelklingen	DE-BW	
Schenefeld (Kreis Pinneberg)	DE-SH	
Scheßlitz	DE-BY	
Schieder-Schwalenberg	DE-NW	
Schifferstadt	DE-RP	
Schillingsfürst	DE-BY	
Schiltach	DE-BW	
Schirgiswalde-Kirschau	DE-SN	
Schkeuditz	DE-SN	
Schkölen	DE-TH	
Schleiden	DE-NW	
Schleiz	DE-TH	
Schleswig	DE-SH	
Schlettau	DE-SN	
Schleusingen	DE-TH	
Schlieben	DE-BB	
Schlitz (Vogelsbergkreis)	DE-HE	
Schloß Holte-Stukenbrock	DE-NW	
Schlotheim	DE-TH	
Schlüchtern	DE-HE	
Schlüsselfeld	DE-BY	
Schmalkalden	DE-TH	
Schmallenberg	DE-NW	
Schmölln	DE-TH	
Schnackenburg	DE-NI	
Schnaittenbach	DE-BY	
Schneeberg (Erzgebirge)	DE-SN	
Schneverdingen	DE-NI	
Schömberg (Zollernalbkreis)	DE-BW	
Schönau (Odenwald)	DE-BW	
Schönau im Schwarzwald	DE-BW	
Schönberg (Mecklenburg)	DE-MV	
Schönebeck (Elbe)	DE-ST	
Schöneck/Vogtl.	DE-SN	
Schönewalde	DE-BB	
Schongau	DE-BY	
Schöningen	DE-NI	
Schönsee	DE-BY	
Schönwald (Bayern)	DE-BY	
Schopfheim	DE-BW	
Schöppenstedt	DE-NI	
Schorndorf	DE-BW	
Schortens	DE-NI	
Schotten (Stadt)	DE-HE	
Schramberg	DE-BW	
Schraplau	DE-ST	
Schriesheim	DE-BW	
Schrobenhausen	DE-BY	
Schrozberg	DE-BW	
Schüttorf	DE-NI	
Schwaan	DE-MV	
Schwabach	DE-BY	
Schwäbisch Gmünd	DE-BW	
Schwäbisch Hall	DE-BW	
Schwabmünchen	DE-BY	
Schwaigern	DE-BW	
Schwalbach am Taunus	DE-HE	
Schwalmstadt	DE-HE	
Schwandorf	DE-BY	
Schwanebeck	DE-ST	
Schwarzenbach am Wald	DE-BY	
Schwarzenbach an der Saale	DE-BY	
Schwarzenbek	DE-SH	
Schwarzenberg/Erzgeb.	DE-SN	
Schwarzenborn (Knüll)	DE-HE	
Schwarzheide	DE-BB	
Schwedt/Oder	DE-BB	
Schweich	DE-RP	
Schweinfurt	DE-BY	
Schwelm	DE-NW	
Schwentinental	DE-SH	
Schwerin	DE-MV	State
Schwerte	DE-NW	
Schwetzingen	DE-BW	
Sebnitz	DE-SN	
Seehausen (Altmark)	DE-ST	
Seeland (Sachsen-Anhalt)	DE-ST	
Seelow	DE-BB	
Seelze	DE-NI	
Seesen	DE-NI	
Sehnde	DE-NI	
Seifhennersdorf	DE-SN	
Selb	DE-BY	
Selbitz (Oberfranken)	DE-BY	
Seligenstadt	DE-HE	
Selm	DE-NW	
Selters (Westerwald)	DE-RP	
Senden (Bayern)	DE-BY	
Sendenhorst	DE-NW	
Senftenberg	DE-BB	
Seßlach	DE-BY	
Siegburg	DE-NW	
Siegen	DE-NW	
Sigmaringen	DE-BW	
Simbach am Inn	DE-BY	
Simmern/Hunsrück	DE-RP	
Sindelfingen	DE-BW	
Singen (Hohentwiel)	DE-BW	
Sinsheim	DE-BW	
Sinzig	DE-RP	
Soest	DE-NW	
Solingen	DE-NW	
Solms	DE-HE	
Soltau	DE-NI	
Sömmerda	DE-TH	
Sondershausen	DE-TH	
Sonneberg	DE-TH	
Sonnewalde	DE-BB	
Sonthofen	DE-BY	
Sontra	DE-HE	
Spaichingen	DE-BW	
Spalt	DE-BY	
Spangenberg	DE-HE	
Speicher (Eifel)	DE-RP	
Spenge	DE-NW	
Speyer	DE-RP	
Spremberg	DE-BB	
Springe	DE-NI	
Sprockhövel	DE-NW	
Stade	DE-NI	
Stadtallendorf	DE-HE	
Stadtbergen	DE-BY	
Stadthagen	DE-NI	
Stadtilm	DE-TH	
Stadtlengsfeld	DE-TH	
Stadtlohn	DE-NW	
Stadtoldendorf	DE-NI	
Stadtprozelten	DE-BY	
Stadtroda	DE-TH	
Stadtsteinach	DE-BY	
Stadt Wehlen	DE-SN	
Starnberg	DE-BY	
Staßfurt	DE-ST	
Staufen im Breisgau	DE-BW	
Staufenberg (Hessen)	DE-HE	
Stavenhagen	DE-MV	
St. Blasien	DE-BW	
Stein (Mittelfranken)	DE-BY	
Steinach (Thüringen)	DE-TH	
Steinau an der Straße	DE-HE	
Steinbach-Hallenberg	DE-TH	
Steinbach (Taunus)	DE-HE	
Steinfurt	DE-NW	
Steinheim an der Murr	DE-BW	
Steinheim (Westfalen)	DE-NW	
Stendal	DE-ST	
Sternberg	DE-MV	
St. Ingbert	DE-SL	
St. Georgen im Schwarzwald	DE-BW	
Stockach	DE-BW	
Stolberg (Rheinland)	DE-NW	
Stollberg/Erzgeb.	DE-SN	
Stolpen	DE-SN	
Storkow (Mark)	DE-BB	
Stößen	DE-ST	
Straelen	DE-NW	
Stralsund	DE-MV	
Strasburg (Uckermark)	DE-MV	
Straubing	DE-BY	
Strausberg	DE-BB	
Strehla	DE-SN	
Stromberg (Hunsrück)	DE-RP	
Stühlingen	DE-BW	
Stutensee	DE-BW	
Stuttgart	DE-BW	State
St. Wendel	DE-SL	
Suhl	DE-TH	
Sulingen	DE-NI	
Sulz am Neckar	DE-BW	
Sulzbach/Saar	DE-SL	
Sulzbach-Rosenberg	DE-BY	
Sulzburg	DE-BW	
Sundern (Sauerland)	DE-NW	
Südliches Anhalt	DE-ST	
Süßen	DE-BW	
Syke	DE-NI	
Tambach-Dietharz	DE-TH	
Tangerhütte	DE-ST	
Tangermünde	DE-ST	
Tann (Rhön)	DE-HE	
Tanna	DE-TH	
Tauberbischofsheim	DE-BW	
Taucha	DE-SN	
Taunusstein	DE-HE	
Tecklenburg	DE-NW	
Tegernsee (Stadt)	DE-BY	
Telgte	DE-NW	
Teltow	DE-BB	
Templin	DE-BB	
Tengen	DE-BW	
Tessin (bei Rostock)	DE-MV	
Teterow	DE-MV	
Tettnang	DE-BW	
Teublitz	DE-BY	
Teuchern	DE-ST	
Teupitz	DE-BB	
Teuschnitz	DE-BY	
Thale	DE-ST	
Thalheim/Erzgeb.	DE-SN	
Thannhausen (Schwaben)	DE-BY	
Tharandt	DE-SN	
Themar	DE-TH	
Thum	DE-SN	
Tirschenreuth	DE-BY	
Titisee-Neustadt	DE-BW	
Tittmoning	DE-BY	
Todtnau	DE-BW	
Töging am Inn	DE-BY	
Tönisvorst	DE-NW	
Tönning	DE-SH	
Torgau	DE-SN	
Torgelow	DE-MV	
Tornesch	DE-SH	
Traben-Trarbach	DE-RP	
Traunreut	DE-BY	
Traunstein	DE-BY	
Trebbin	DE-BB	
Trebsen/Mulde	DE-SN	
Treffurt	DE-TH	
Trendelburg	DE-HE	
Treuchtlingen	DE-BY	
Treuen	DE-SN	
Treuenbrietzen	DE-BB	
Triberg im Schwarzwald	DE-BW	
Tribsees	DE-MV	
Trier	DE-RP	
Triptis	DE-TH	
Trochtelfingen	DE-BW	
Troisdorf	DE-NW	
Trossingen	DE-BW	
Trostberg	DE-BY	
Tübingen	DE-BW	
Tuttlingen	DE-BW	
Twistringen	DE-NI	
Übach-Palenberg	DE-NW	
Überlingen	DE-BW	
Uebigau-Wahrenbrück	DE-BB	
Ueckermünde	DE-MV	
Uelzen	DE-NI	
Uetersen	DE-SH	
Uffenheim	DE-BY	
Uhingen	DE-BW	
Ulm	DE-BW	
Ulmen (Eifel)	DE-RP	
Ulrichstein	DE-HE	
Ummerstadt	DE-TH	
Unkel	DE-RP	
Unna	DE-NW	
Unterschleißheim	DE-BY	
Usedom (Stadt)	DE-MV	
Usingen	DE-HE	
Uslar	DE-NI	
Vacha	DE-TH	
Vaihingen an der Enz	DE-BW	
Vallendar	DE-RP	
Varel	DE-NI	
Vechta	DE-NI	
Velbert	DE-NW	
Velburg	DE-BY	
Velden (Pegnitz)	DE-BY	
Vellberg	DE-BW	
Velen	DE-NW	
Vellmar	DE-HE	
Velten	DE-BB	
Verden (Aller)	DE-NI	
Veringenstadt	DE-BW	
Verl	DE-NW	
Versmold	DE-NW	
Vetschau/Spreewald	DE-BB	
Viechtach	DE-BY	
Viernheim	DE-HE	
Viersen	DE-NW	
Villingen-Schwenningen	DE-BW	
Vilsbiburg	DE-BY	
Vilseck	DE-BY	
Vilshofen an der Donau	DE-BY	
Visselhövede	DE-NI	
Vlotho	DE-NW	
Voerde (Niederrhein)	DE-NW	
Vogtsburg im Kaiserstuhl	DE-BW	
Vohburg an der Donau	DE-BY	
Vohenstrauß	DE-BY	
Vöhrenbach	DE-BW	
Vöhringen (Iller)	DE-BY	
Volkach	DE-BY	
Völklingen	DE-SL	
Volkmarsen	DE-HE	
Vreden	DE-NW	
Wachenheim an der Weinstraße	DE-RP	
Wächtersbach	DE-HE	
Wadern	DE-SL	
Waghäusel	DE-BW	
Wahlstedt	DE-SH	
Waiblingen	DE-BW	
Waibstadt	DE-BW	
Waischenfeld	DE-BY	
Waldbröl	DE-NW	
Waldeck (Stadt)	DE-HE	
Waldenbuch	DE-BW	
Waldenburg (Sachsen)	DE-SN	
Waldenburg (Württemberg)	DE-BW	
Waldershof	DE-BY	
Waldheim	DE-SN	
Waldkappel	DE-HE	
Waldkirch	DE-BW	
Waldkirchen	DE-BY	
Waldkraiburg	DE-BY	
Waldmünchen	DE-BY	
Waldsassen	DE-BY	
Waldshut-Tiengen	DE-BW	
Walldorf (Baden)	DE-BW	
Walldürn	DE-BW	
Wallenfels	DE-BY	
Walsrode	DE-NI	
Waltershausen	DE-TH	
Waltrop	DE-NW	
Wanfried	DE-HE	
Wangen im Allgäu	DE-BW	
Wanzleben-Börde	DE-ST	
Warburg	DE-NW	
Waren (Müritz)	DE-MV	
Warendorf	DE-NW	
Warin	DE-MV	
Warstein	DE-NW	
Wassenberg	DE-NW	
Wasserburg am Inn	DE-BY	
Wassertrüdingen	DE-BY	
Wasungen	DE-TH	
Wedel	DE-SH	
Weener	DE-NI	
Wegberg	DE-NW	
Wegeleben	DE-ST	
Wehr (Baden)	DE-BW	
Weida	DE-TH	
Weiden in der Oberpfalz	DE-BY	
Weikersheim	DE-BW	
Weil am Rhein	DE-BW	
Weilburg	DE-HE	
Weil der Stadt	DE-BW	
Weilheim an der Teck	DE-BW	
Weilheim in Oberbayern	DE-BY	
Weimar	DE-TH	
Weingarten (Württemberg)	DE-BW	
Weinheim	DE-BW	
Weinsberg	DE-BW	
Weinstadt	DE-BW	
Weismain	DE-BY	
Weißenberg	DE-SN	
Weißenburg in Bayern	DE-BY	
Weißenfels	DE-ST	
Weißenhorn	DE-BY	
Weißensee (Thüringen)	DE-TH	
Weißenstadt	DE-BY	
Weißenthurm	DE-RP	
Weißwasser/Oberlausitz	DE-SN	
Weiterstadt	DE-HE	
Welzheim	DE-BW	
Welzow	DE-BB	
Wemding	DE-BY	
Wendlingen am Neckar	DE-BW	
Werben (Elbe)	DE-ST	
Werdau	DE-SN	
Werder (Havel)	DE-BB	
Werdohl	DE-NW	
Werl	DE-NW	
Wermelskirchen	DE-NW	
Wernau (Neckar)	DE-BW	
Werne	DE-NW	
Werneuchen	DE-BB	
Wernigerode	DE-ST	
Wertheim	DE-BW	
Werther (Westf.)	DE-NW	
Wertingen	DE-BY	
Wesel	DE-NW	
Wesenberg (Mecklenburg)	DE-MV	
Wesselburen	DE-SH	
Wesseling	DE-NW	
Westerburg	DE-RP	
Westerstede	DE-NI	
Wetter (Ruhr)	DE-NW	
Wetter (Hessen)	DE-HE	
Wettin-Löbejün	DE-ST	
Wetzlar	DE-HE	
Widdern	DE-BW	
Wiehe	DE-TH	
Wiehl	DE-NW	
Wiesbaden	DE-HE	State
Wiesmoor	DE-NI	
Wiesensteig	DE-BW	
Wiesloch	DE-BW	
Wildau	DE-BB	
Wildberg (Schwarzwald)	DE-BW	
Wildenfels	DE-SN	
Wildeshausen	DE-NI	
Wilhelmshaven	DE-NI	
Wilkau-Haßlau	DE-SN	
Willebadessen	DE-NW	
Willich	DE-NW	
Wilsdruff	DE-SN	
Wilster	DE-SH	
Wilthen	DE-SN	
Windischeschenbach	DE-BY	
Windsbach	DE-BY	
Winnenden	DE-BW	
Winsen (Luhe)	DE-NI	
Winterberg	DE-NW	
Wipperfürth	DE-NW	
Wirges	DE-RP	
Wismar	DE-MV	
Wissen (Stadt)	DE-RP	
Witten	DE-NW	
Lutherstadt Wittenberg	DE-ST	
Wittenberge	DE-BB	
Wittenburg	DE-MV	
Wittichenau	DE-SN	
Wittlich	DE-RP	
Wittingen	DE-NI	
Wittmund	DE-NI	
Wittstock/Dosse	DE-BB	
Witzenhausen	DE-HE	
Woldegk	DE-MV	
Wolfach	DE-BW	
Wolfenbüttel	DE-NI	
Wolfhagen	DE-HE	
Wolframs-Eschenbach	DE-BY	
Wolfratshausen	DE-BY	
Wolfsburg	DE-NI	
Wolfstein	DE-RP	
Wolgast	DE-MV	
Wolkenstein (Erzgebirge)	DE-SN	
Wolmirstedt	DE-ST	
Worms	DE-RP	
Wörrstadt	DE-RP	
Wörth am Rhein	DE-RP	
Wörth an der Donau	DE-BY	
Wörth am Main	DE-BY	
Wriezen	DE-BB	
Wülfrath	DE-NW	
Wunsiedel	DE-BY	
Wunstorf	DE-NI	
Wuppertal	DE-NW	
Würselen	DE-NW	
Wurzbach	DE-TH	
Würzburg	DE-BY	
Wurzen	DE-SN	
Wustrow (Wendland)	DE-NI	
Wyk auf Föhr	DE-SH	
Xanten	DE-NW	
Zahna-Elster	DE-ST	
Zarrentin am Schaalsee	DE-MV	
Zehdenick	DE-BB	
Zeil am Main	DE-BY	
Zeitz	DE-ST	
Zell am Harmersbach	DE-BW	
Zell im Wiesental	DE-BW	
Zell (Mosel)	DE-RP	
Zella-Mehlis	DE-TH	
Zerbst/Anhalt	DE-ST	
Zeulenroda-Triebes	DE-TH	
Zeven	DE-NI	
Ziegenrück	DE-TH	
Zierenberg	DE-HE	
Ziesar	DE-BB	
Zirndorf	DE-BY	
Zittau	DE-SN	
Zörbig	DE-ST	
Zossen	DE-BB	
Zschopau	DE-SN	
Zülpich	DE-NW	
Zweibrücken	DE-RP	
Zwenkau	DE-SN	
Zwickau	DE-SN	
Zwiesel	DE-BY	
Zwingenberg (Bergstraße)	DE-HE	
Zwönitz	DE-SN	
